1111111111111111111111111
1P0000C00000C000000000C01
1000000010010000010000001
100000001C0100C01100000C1
10C000001C01C000010000001
1000000011110000010000001
10000000000100C0010000001
100000000C010000010000001
100C000000000C000000000E1
1111111111111111111111111