11111111111111111
1P0100C111C00C0C1
1C010100100110101
1C010100100110101
1C010100100110101
1C010100100110101
1C010100100110101
1C010100100110101
1000C1C00C111C0E1
11111111111111111